####################
#G.G............G.G#
#..................#
#-.....GGG..GGG...-#
#G..############..G#
#-..#...GGGGGGG...-#
#..G#......A.......#
#..-#...--------...#
#G..#G.G........G.G#
#-..#---...--...---#
#..G#.......A......#
#..-#-..############
#...#..............#
#1..#......A......X#
####################
